1 13 31
###############################
#p        * 5 #   *  f     0  #
# # # # # # #*#*# # # # # #*# #
#    0         *   1  *   *   #
# b#   #   # # #* *#    #   * #
# l     x **  *  *            #
#### ######### ##### # # # ####
#*  *       *4 *   2  *       #
#s  #0  #*  # # #   #   #   # #
#*           *                #
# #   # # # # # #*# # #   # # #
#     0    b *# *   0         #
###############################
